0 2 3 1 3 4 1 6 5 3 1 1 3 4 1 4 4 4 4 3 6 
0 2 3 1 3 4 1 6 5 3 1 2 3 4 1 4 4 4 4 3 6 
0 2 3 1 3 4 1 6 5 3 1 3 3 4 1 4 4 4 4 3 6 
0 2 3 1 3 4 1 6 5 3 1 4 3 4 1 4 4 4 4 3 6 
0 1 3 1 3 4 1 6 5 3 1 4 3 4 1 4 4 4 4 3 6 
0 1 3 1 3 3 1 6 5 3 1 4 3 4 1 4 4 4 4 3 6 
0 1 3 1 3 3 1 6 5 3 1 4 3 4 1 4 4 4 4 2 6 
0 1 3 1 3 2 1 6 5 3 1 4 3 4 1 4 4 4 4 2 6 
0 1 3 1 3 1 1 6 5 3 1 4 3 4 1 4 4 4 4 2 6 
0 1 3 1 3 1 1 6 5 3 1 4 3 4 1 4 3 4 4 2 6 
0 2 3 1 3 1 1 6 5 3 1 4 3 4 1 4 3 4 4 2 6 
0 2 3 1 3 1 1 6 5 3 1 4 3 4 1 4 4 4 4 2 6 
0 2 3 1 3 1 1 6 5 3 1 3 3 4 1 4 4 4 4 2 6 
0 2 3 1 3 1 1 6 5 3 1 3 3 4 1 4 4 4 4 1 6 
0 2 3 1 3 1 1 6 5 3 1 3 3 4 1 4 3 4 4 1 6 
0 2 3 1 3 1 1 6 5 3 1 2 3 4 1 4 3 4 4 1 6 
0 2 3 1 3 1 1 6 5 3 1 2 3 4 1 4 2 4 4 1 6 
0 2 3 1 3 1 1 6 5 3 1 1 3 4 1 4 2 4 4 1 6 
0 2 3 1 3 1 1 6 4 3 1 1 3 4 1 4 2 4 4 1 6 
0 2 3 1 3 1 1 6 4 3 1 1 3 4 1 4 1 4 4 1 6 
0 2 3 1 3 1 1 6 5 3 1 1 3 4 1 4 1 4 4 1 6 
0 2 3 1 3 1 1 6 5 3 1 1 3 4 2 4 1 4 4 1 6 
0 2 3 1 3 1 1 6 5 3 1 1 3 4 3 4 1 4 4 1 6 
0 2 3 1 3 1 1 6 5 3 1 1 3 4 4 4 1 4 4 1 6 
0 3 3 1 3 1 1 6 5 3 1 1 3 4 4 4 1 4 4 1 6 
0 4 3 1 3 1 1 6 5 3 1 1 3 4 4 4 1 4 4 1 6 
0 5 3 1 3 1 1 6 5 3 1 1 3 4 4 4 1 4 4 1 6 