0 2 3 2 1 1 3 4 1 1 5 1 1 6 1 1 1 3 2 1 5 2 1 6 3 3 4 2 4 4 3 6 3 
0 2 3 2 1 1 3 4 1 1 5 1 1 6 1 1 1 3 2 1 5 2 1 6 3 3 4 2 4 4 3 6 4 
0 2 3 2 1 1 3 4 1 1 5 1 1 6 2 1 1 3 2 1 5 2 1 6 3 3 4 2 4 4 3 6 4 
0 2 3 2 1 1 3 4 1 1 5 2 1 6 2 1 1 3 2 1 5 2 1 6 3 3 4 2 4 4 3 6 4 
0 2 3 2 1 1 3 4 1 1 5 2 1 6 2 1 1 2 2 1 5 2 1 6 3 3 4 2 4 4 3 6 4 
0 2 3 2 2 1 3 4 1 1 5 2 1 6 2 1 1 2 2 1 5 2 1 6 3 3 4 2 4 4 3 6 4 
0 2 3 2 2 1 3 4 1 1 5 2 1 6 1 1 1 2 2 1 5 2 1 6 3 3 4 2 4 4 3 6 4 
0 2 3 2 2 1 3 4 1 1 5 1 1 6 1 1 1 2 2 1 5 2 1 6 3 3 4 2 4 4 3 6 4 
0 2 3 2 2 1 3 4 1 1 5 1 1 6 2 1 1 2 2 1 5 2 1 6 3 3 4 2 4 4 3 6 4 
0 2 3 2 2 1 3 4 1 1 5 1 1 6 2 1 1 1 2 1 5 2 1 6 3 3 4 2 4 4 3 6 4 
0 1 3 2 2 1 3 4 1 1 5 1 1 6 2 1 1 1 2 1 5 2 1 6 3 3 4 2 4 4 3 6 4 
0 1 3 2 2 1 3 4 1 1 5 1 1 6 2 1 1 1 2 1 5 2 1 6 3 3 3 2 4 4 3 6 4 
0 1 3 2 2 1 3 4 1 1 5 1 1 6 2 1 1 1 2 1 5 2 1 6 3 3 2 2 4 4 3 6 4 
0 1 3 2 2 1 3 4 1 1 5 1 1 6 2 1 1 1 2 1 5 2 2 6 3 3 2 2 4 4 3 6 4 
0 1 3 2 2 1 3 4 1 1 5 1 1 6 2 1 1 1 2 1 5 2 3 6 3 3 2 2 4 4 3 6 4 
0 1 3 2 2 1 3 4 1 1 5 1 1 6 2 1 1 1 2 1 5 2 4 6 3 3 2 2 4 4 3 6 4 
0 1 3 2 2 1 3 4 1 1 5 1 1 6 2 1 1 1 2 2 5 2 4 6 3 3 2 2 4 4 3 6 4 
0 1 3 2 2 1 3 4 1 1 5 1 1 6 1 1 1 1 2 2 5 2 4 6 3 3 2 2 4 4 3 6 4 
0 1 3 2 2 1 3 4 1 1 5 2 1 6 1 1 1 1 2 2 5 2 4 6 3 3 2 2 4 4 3 6 4 
0 1 3 2 2 1 3 4 1 1 5 2 1 6 1 1 1 1 2 3 5 2 4 6 3 3 2 2 4 4 3 6 4 
0 1 3 2 2 1 3 4 1 1 5 2 1 6 1 1 1 1 2 3 5 2 3 6 3 3 2 2 4 4 3 6 4 
0 1 3 2 2 1 3 4 1 1 5 2 1 6 1 1 1 1 2 3 5 2 3 6 3 3 2 2 4 4 3 6 3 
0 1 3 2 2 1 3 4 1 1 5 2 1 6 1 1 1 1 2 4 5 2 3 6 3 3 2 2 4 4 3 6 3 
0 1 3 2 2 1 3 4 1 1 5 2 1 6 1 1 1 1 2 4 5 2 4 6 3 3 2 2 4 4 3 6 3 
0 1 3 2 2 1 3 4 1 1 5 2 1 6 1 1 1 1 2 4 5 2 5 6 3 3 2 2 4 4 3 6 3 
0 1 3 2 2 1 3 4 1 1 5 2 1 6 1 1 1 1 2 4 5 2 5 6 3 3 3 2 4 4 3 6 3 
0 1 3 2 2 1 3 4 1 1 5 2 1 6 1 1 1 1 2 4 5 2 5 6 3 3 4 2 4 4 3 6 3 
0 2 3 2 2 1 3 4 1 1 5 2 1 6 1 1 1 1 2 4 5 2 5 6 3 3 4 2 4 4 3 6 3 
0 2 3 2 2 1 3 4 1 1 5 2 1 6 1 1 1 1 2 4 5 2 4 6 3 3 4 2 4 4 3 6 3 
0 2 3 2 2 1 3 4 1 1 5 2 1 6 1 1 1 1 2 4 5 2 4 6 3 3 4 2 4 4 3 6 4 
0 2 3 2 2 1 3 4 1 1 5 2 1 6 1 1 1 2 2 4 5 2 4 6 3 3 4 2 4 4 3 6 4 
0 2 3 2 2 1 3 4 1 1 5 2 1 6 1 1 1 3 2 4 5 2 4 6 3 3 4 2 4 4 3 6 4 
0 2 3 2 2 1 3 4 1 1 5 2 1 6 1 1 1 4 2 4 5 2 4 6 3 3 4 2 4 4 3 6 4 
0 2 3 2 2 1 3 4 1 1 5 2 1 6 1 1 1 4 2 4 5 2 4 6 3 3 4 2 4 4 3 6 3 
0 2 3 2 1 1 3 4 1 1 5 2 1 6 1 1 1 4 2 4 5 2 4 6 3 3 4 2 4 4 3 6 3 
0 2 3 2 1 1 3 4 1 1 5 2 1 6 1 1 1 4 2 4 5 2 5 6 3 3 4 2 4 4 3 6 3 
0 1 3 2 1 1 3 4 1 1 5 2 1 6 1 1 1 4 2 4 5 2 5 6 3 3 4 2 4 4 3 6 3 
0 1 3 2 2 1 3 4 1 1 5 2 1 6 1 1 1 4 2 4 5 2 5 6 3 3 4 2 4 4 3 6 3 
0 1 3 2 2 1 3 4 1 1 5 2 1 6 1 1 1 5 2 4 5 2 5 6 3 3 4 2 4 4 3 6 3 
0 1 3 2 2 1 3 4 1 1 5 2 1 6 1 1 1 5 2 4 5 2 5 6 3 3 3 2 4 4 3 6 3 
0 1 3 2 2 1 3 4 1 1 5 2 1 6 1 1 1 5 2 4 5 2 5 6 3 3 2 2 4 4 3 6 3 
0 1 3 2 2 1 3 4 1 1 5 2 1 6 1 1 1 5 2 3 5 2 5 6 3 3 2 2 4 4 3 6 3 
0 1 3 2 2 1 3 4 1 1 5 2 1 6 1 1 1 5 2 3 5 2 4 6 3 3 2 2 4 4 3 6 3 
0 1 3 2 2 1 3 4 1 1 5 2 1 6 1 1 1 5 2 2 5 2 4 6 3 3 2 2 4 4 3 6 3 
0 1 3 2 2 1 3 4 1 1 5 2 1 6 1 1 1 5 2 2 5 2 5 6 3 3 2 2 4 4 3 6 3 
0 1 3 2 2 1 3 4 1 1 5 2 1 6 1 1 1 4 2 2 5 2 5 6 3 3 2 2 4 4 3 6 3 
0 1 3 2 1 1 3 4 1 1 5 2 1 6 1 1 1 4 2 2 5 2 5 6 3 3 2 2 4 4 3 6 3 
0 1 3 2 1 1 3 4 1 1 5 2 1 6 1 1 1 4 2 3 5 2 5 6 3 3 2 2 4 4 3 6 3 
0 1 3 2 1 1 3 4 1 1 5 2 1 6 1 1 1 5 2 3 5 2 5 6 3 3 2 2 4 4 3 6 3 
0 1 3 2 1 1 3 4 1 1 5 2 1 6 1 1 1 5 2 3 5 2 5 6 3 3 1 2 4 4 3 6 3 
0 1 3 2 1 1 3 4 1 1 5 2 1 6 1 1 1 5 2 3 5 2 5 6 3 3 1 2 3 4 3 6 3 
0 1 3 2 1 1 3 4 1 1 5 3 1 6 1 1 1 5 2 3 5 2 5 6 3 3 1 2 3 4 3 6 3 
0 1 3 2 1 1 3 4 1 1 5 3 1 6 1 1 1 5 2 3 5 2 4 6 3 3 1 2 3 4 3 6 3 
0 1 3 2 1 1 3 4 1 1 5 4 1 6 1 1 1 5 2 3 5 2 4 6 3 3 1 2 3 4 3 6 3 
0 1 3 2 1 1 3 4 1 1 5 4 1 6 1 1 1 5 2 3 5 2 3 6 3 3 1 2 3 4 3 6 3 
0 1 3 2 1 1 3 4 1 1 5 4 1 6 1 1 1 5 2 3 5 2 3 6 3 3 1 2 2 4 3 6 3 
0 1 3 2 1 1 3 4 1 1 5 4 1 6 1 1 1 5 2 3 5 2 3 6 3 3 1 2 2 4 3 6 4 
0 1 3 2 1 1 3 4 2 1 5 4 1 6 1 1 1 5 2 3 5 2 3 6 3 3 1 2 2 4 3 6 4 
0 1 3 2 1 1 3 4 2 1 5 4 1 6 1 1 1 5 2 3 5 2 2 6 3 3 1 2 2 4 3 6 4 
0 1 3 2 1 1 3 4 2 1 5 5 1 6 1 1 1 5 2 3 5 2 2 6 3 3 1 2 2 4 3 6 4 
0 1 3 2 1 1 3 4 2 1 5 5 1 6 1 1 1 5 2 3 5 2 2 6 3 3 1 2 1 4 3 6 4 
0 1 3 2 1 1 3 4 2 1 5 5 1 6 1 1 1 5 2 2 5 2 2 6 3 3 1 2 1 4 3 6 4 
0 1 3 2 1 1 3 4 2 1 5 5 1 6 2 1 1 5 2 2 5 2 2 6 3 3 1 2 1 4 3 6 4 
0 1 3 2 1 1 3 4 2 1 5 5 1 6 2 1 1 5 2 2 5 2 3 6 3 3 1 2 1 4 3 6 4 
0 1 3 2 1 1 3 4 2 1 5 5 1 6 2 1 1 5 2 2 5 2 3 6 3 3 2 2 1 4 3 6 4 
0 1 3 2 2 1 3 4 2 1 5 5 1 6 2 1 1 5 2 2 5 2 3 6 3 3 2 2 1 4 3 6 4 
0 1 3 2 2 1 3 4 2 1 5 5 1 6 2 1 1 5 2 3 5 2 3 6 3 3 2 2 1 4 3 6 4 
0 1 3 2 2 1 3 4 2 1 5 5 1 6 1 1 1 5 2 3 5 2 3 6 3 3 2 2 1 4 3 6 4 
0 1 3 2 2 1 3 4 2 1 5 5 1 6 1 1 1 5 2 2 5 2 3 6 3 3 2 2 1 4 3 6 4 
0 1 3 2 2 1 3 4 2 1 5 4 1 6 1 1 1 5 2 2 5 2 3 6 3 3 2 2 1 4 3 6 4 
0 1 3 2 2 1 3 4 3 1 5 4 1 6 1 1 1 5 2 2 5 2 3 6 3 3 2 2 1 4 3 6 4 
0 1 3 2 3 1 3 4 3 1 5 4 1 6 1 1 1 5 2 2 5 2 3 6 3 3 2 2 1 4 3 6 4 
0 1 3 2 3 1 3 4 3 1 5 3 1 6 1 1 1 5 2 2 5 2 3 6 3 3 2 2 1 4 3 6 4 
0 1 3 2 3 1 3 4 3 1 5 3 1 6 1 1 1 5 2 2 5 2 3 6 3 3 2 2 1 4 3 6 3 
0 1 3 2 4 1 3 4 3 1 5 3 1 6 1 1 1 5 2 2 5 2 3 6 3 3 2 2 1 4 3 6 3 
0 1 3 2 4 1 3 4 3 1 5 3 1 6 1 1 1 5 2 2 5 2 3 6 3 3 1 2 1 4 3 6 3 
0 1 3 2 4 1 3 4 3 1 5 3 1 6 1 1 1 5 2 2 5 2 3 6 3 3 1 2 2 4 3 6 3 
0 1 3 2 4 1 3 4 2 1 5 3 1 6 1 1 1 5 2 2 5 2 3 6 3 3 1 2 2 4 3 6 3 
0 1 3 2 4 1 3 4 2 1 5 4 1 6 1 1 1 5 2 2 5 2 3 6 3 3 1 2 2 4 3 6 3 
0 1 3 2 4 1 3 4 2 1 5 4 1 6 1 1 1 5 2 3 5 2 3 6 3 3 1 2 2 4 3 6 3 
0 1 3 2 4 1 3 4 2 1 5 4 1 6 1 1 1 5 2 3 5 2 3 6 3 3 1 2 1 4 3 6 3 
0 1 3 2 4 1 3 4 2 1 5 4 1 6 1 1 1 5 2 3 5 2 2 6 3 3 1 2 1 4 3 6 3 
0 1 3 2 4 1 3 4 2 1 5 5 1 6 1 1 1 5 2 3 5 2 2 6 3 3 1 2 1 4 3 6 3 
0 1 3 2 4 1 3 4 2 1 5 5 1 6 1 1 1 5 2 3 5 2 2 6 3 3 1 2 1 4 3 6 4 
0 1 3 2 4 1 3 4 2 1 5 5 1 6 1 1 1 5 2 3 5 2 3 6 3 3 1 2 1 4 3 6 4 
0 1 3 2 4 1 3 4 2 1 5 5 1 6 1 1 1 5 2 3 5 2 3 6 3 3 1 2 1 4 3 6 3 
0 1 3 2 4 1 3 4 2 1 5 5 1 6 1 1 1 5 2 2 5 2 3 6 3 3 1 2 1 4 3 6 3 
0 1 3 2 4 1 3 4 3 1 5 5 1 6 1 1 1 5 2 2 5 2 3 6 3 3 1 2 1 4 3 6 3 
0 1 3 2 4 1 3 4 3 1 5 5 1 6 1 1 1 5 2 2 5 2 3 6 3 3 1 2 1 4 3 6 4 
0 1 3 2 4 1 3 4 3 1 5 5 1 6 1 1 1 5 2 2 5 2 3 6 3 3 1 2 2 4 3 6 4 
0 1 3 2 4 1 3 4 3 1 5 5 1 6 2 1 1 5 2 2 5 2 3 6 3 3 1 2 2 4 3 6 4 
0 1 3 2 4 1 3 4 3 1 5 5 1 6 2 1 1 5 2 2 5 2 2 6 3 3 1 2 2 4 3 6 4 
0 1 3 2 4 1 3 4 3 1 5 4 1 6 2 1 1 5 2 2 5 2 2 6 3 3 1 2 2 4 3 6 4 
0 1 3 2 5 1 3 4 3 1 5 4 1 6 2 1 1 5 2 2 5 2 2 6 3 3 1 2 2 4 3 6 4 
0 1 3 2 5 1 3 4 2 1 5 4 1 6 2 1 1 5 2 2 5 2 2 6 3 3 1 2 2 4 3 6 4 
0 1 3 2 5 1 3 4 2 1 5 4 1 6 2 1 1 4 2 2 5 2 2 6 3 3 1 2 2 4 3 6 4 
0 1 3 2 5 1 3 4 1 1 5 4 1 6 2 1 1 4 2 2 5 2 2 6 3 3 1 2 2 4 3 6 4 
0 1 3 2 5 1 3 4 1 1 5 4 1 6 2 1 1 4 2 2 5 2 2 6 3 3 1 2 3 4 3 6 4 
0 1 3 2 5 1 3 4 1 1 5 3 1 6 2 1 1 4 2 2 5 2 2 6 3 3 1 2 3 4 3 6 4 
0 1 3 2 5 1 3 4 1 1 5 3 1 6 2 1 1 4 2 2 5 2 1 6 3 3 1 2 3 4 3 6 4 
0 1 3 2 5 1 3 4 1 1 5 3 1 6 2 1 1 4 2 3 5 2 1 6 3 3 1 2 3 4 3 6 4 
0 1 3 2 5 1 3 4 1 1 5 3 1 6 2 1 1 4 2 3 5 2 2 6 3 3 1 2 3 4 3 6 4 
0 1 3 2 5 1 3 4 1 1 5 2 1 6 2 1 1 4 2 3 5 2 2 6 3 3 1 2 3 4 3 6 4 
0 1 3 2 5 1 3 4 1 1 5 2 1 6 2 1 1 4 2 3 5 2 2 6 3 3 1 2 4 4 3 6 4 
0 1 3 2 5 1 3 4 1 1 5 2 1 6 2 1 1 5 2 3 5 2 2 6 3 3 1 2 4 4 3 6 4 
0 1 3 2 5 1 3 4 1 1 5 2 1 6 2 1 1 5 2 3 5 2 2 6 3 3 2 2 4 4 3 6 4 
0 1 3 2 5 1 3 4 1 1 5 2 1 6 2 1 1 5 2 3 5 2 3 6 3 3 2 2 4 4 3 6 4 
0 1 3 2 5 1 3 4 1 1 5 2 1 6 2 1 1 5 2 2 5 2 3 6 3 3 2 2 4 4 3 6 4 
0 1 3 2 5 1 3 4 1 1 5 2 1 6 2 1 1 5 2 2 5 2 4 6 3 3 2 2 4 4 3 6 4 
0 1 3 2 5 1 3 4 1 1 5 2 1 6 2 1 1 5 2 3 5 2 4 6 3 3 2 2 4 4 3 6 4 
0 1 3 2 5 1 3 4 1 1 5 2 1 6 2 1 1 4 2 3 5 2 4 6 3 3 2 2 4 4 3 6 4 
0 1 3 2 5 1 3 4 1 1 5 2 1 6 2 1 1 4 2 4 5 2 4 6 3 3 2 2 4 4 3 6 4 
0 1 3 2 5 1 3 4 1 1 5 2 1 6 2 1 1 5 2 4 5 2 4 6 3 3 2 2 4 4 3 6 4 
0 1 3 2 5 1 3 4 1 1 5 2 1 6 2 1 1 5 2 4 5 2 4 6 3 3 3 2 4 4 3 6 4 
0 1 3 2 5 1 3 4 1 1 5 2 1 6 2 1 1 4 2 4 5 2 4 6 3 3 3 2 4 4 3 6 4 
0 1 3 2 5 1 3 4 1 1 5 2 1 6 2 1 1 4 2 4 5 2 4 6 3 3 4 2 4 4 3 6 4 
0 2 3 2 5 1 3 4 1 1 5 2 1 6 2 1 1 4 2 4 5 2 4 6 3 3 4 2 4 4 3 6 4 
0 2 3 2 5 1 3 4 1 1 5 2 1 6 2 1 1 3 2 4 5 2 4 6 3 3 4 2 4 4 3 6 4 
0 2 3 2 5 1 3 4 1 1 5 2 1 6 2 1 1 2 2 4 5 2 4 6 3 3 4 2 4 4 3 6 4 
0 2 3 2 5 1 3 4 1 1 5 2 1 6 2 1 1 1 2 4 5 2 4 6 3 3 4 2 4 4 3 6 4 
0 1 3 2 5 1 3 4 1 1 5 2 1 6 2 1 1 1 2 4 5 2 4 6 3 3 4 2 4 4 3 6 4 
0 1 3 2 5 1 3 4 1 1 5 2 1 6 2 1 1 1 2 4 5 2 4 6 3 3 3 2 4 4 3 6 4 
0 1 3 2 5 1 3 4 1 1 5 2 1 6 2 1 1 1 2 4 5 2 4 6 3 3 2 2 4 4 3 6 4 
0 1 3 2 5 1 3 4 1 1 5 2 1 6 2 1 1 1 2 4 5 2 3 6 3 3 2 2 4 4 3 6 4 
0 1 3 2 5 1 3 4 1 1 5 2 1 6 2 1 1 1 2 4 5 2 3 6 3 3 1 2 4 4 3 6 4 
0 1 3 2 5 1 3 4 1 1 5 2 1 6 2 1 1 1 2 4 5 2 2 6 3 3 1 2 4 4 3 6 4 
0 1 3 2 5 1 3 4 1 1 5 2 1 6 2 1 1 1 2 4 5 2 2 6 3 3 1 2 3 4 3 6 4 
0 1 3 2 5 1 3 4 1 1 5 2 1 6 2 1 1 1 2 4 5 2 2 6 3 3 1 2 2 4 3 6 4 
0 1 3 2 5 1 3 4 2 1 5 2 1 6 2 1 1 1 2 4 5 2 2 6 3 3 1 2 2 4 3 6 4 
0 1 3 2 5 1 3 4 2 1 5 2 1 6 2 1 1 1 2 3 5 2 2 6 3 3 1 2 2 4 3 6 4 
0 1 3 2 5 1 3 4 1 1 5 2 1 6 2 1 1 1 2 3 5 2 2 6 3 3 1 2 2 4 3 6 4 
0 1 3 2 5 1 3 4 1 1 5 2 1 6 2 1 1 1 2 3 5 2 1 6 3 3 1 2 2 4 3 6 4 
0 1 3 2 5 1 3 4 1 1 5 2 1 6 2 1 1 1 2 2 5 2 1 6 3 3 1 2 2 4 3 6 4 
0 1 3 2 5 1 3 4 1 1 5 3 1 6 2 1 1 1 2 2 5 2 1 6 3 3 1 2 2 4 3 6 4 
0 1 3 2 5 1 3 4 2 1 5 3 1 6 2 1 1 1 2 2 5 2 1 6 3 3 1 2 2 4 3 6 4 
0 1 3 2 5 1 3 4 2 1 5 3 1 6 2 1 1 1 2 1 5 2 1 6 3 3 1 2 2 4 3 6 4 
0 1 3 2 5 1 3 4 3 1 5 3 1 6 2 1 1 1 2 1 5 2 1 6 3 3 1 2 2 4 3 6 4 
0 1 3 2 5 1 3 4 3 1 5 3 1 6 2 1 1 1 2 1 5 2 1 6 3 3 1 2 1 4 3 6 4 
0 1 3 2 4 1 3 4 3 1 5 3 1 6 2 1 1 1 2 1 5 2 1 6 3 3 1 2 1 4 3 6 4 
0 1 3 2 4 1 3 4 3 1 5 2 1 6 2 1 1 1 2 1 5 2 1 6 3 3 1 2 1 4 3 6 4 
0 1 3 2 4 1 3 4 2 1 5 2 1 6 2 1 1 1 2 1 5 2 1 6 3 3 1 2 1 4 3 6 4 
0 1 3 2 4 1 3 4 2 1 5 2 1 6 2 1 1 1 2 1 5 2 1 6 3 3 1 2 2 4 3 6 4 
0 1 3 2 4 1 3 4 2 1 5 3 1 6 2 1 1 1 2 1 5 2 1 6 3 3 1 2 2 4 3 6 4 
0 1 3 2 4 1 3 4 2 1 5 4 1 6 2 1 1 1 2 1 5 2 1 6 3 3 1 2 2 4 3 6 4 
0 1 3 2 4 1 3 4 3 1 5 4 1 6 2 1 1 1 2 1 5 2 1 6 3 3 1 2 2 4 3 6 4 
0 1 3 2 4 1 3 4 3 1 5 4 1 6 2 1 1 1 2 1 5 2 1 6 3 3 1 2 1 4 3 6 4 
0 1 3 2 4 1 3 4 2 1 5 4 1 6 2 1 1 1 2 1 5 2 1 6 3 3 1 2 1 4 3 6 4 
0 1 3 2 4 1 3 4 2 1 5 4 1 6 1 1 1 1 2 1 5 2 1 6 3 3 1 2 1 4 3 6 4 
0 1 3 2 4 1 3 4 2 1 5 4 1 6 1 1 1 1 2 1 5 2 1 6 3 3 2 2 1 4 3 6 4 
0 1 3 2 4 1 3 4 2 1 5 4 1 6 1 1 1 1 2 1 5 2 2 6 3 3 2 2 1 4 3 6 4 
0 1 3 2 4 1 3 4 3 1 5 4 1 6 1 1 1 1 2 1 5 2 2 6 3 3 2 2 1 4 3 6 4 
0 1 3 2 4 1 3 4 3 1 5 4 1 6 1 1 1 1 2 1 5 2 2 6 3 3 3 2 1 4 3 6 4 
0 1 3 2 4 1 3 4 3 1 5 4 1 6 1 1 1 1 2 1 5 2 3 6 3 3 3 2 1 4 3 6 4 
0 1 3 2 4 1 3 4 2 1 5 4 1 6 1 1 1 1 2 1 5 2 3 6 3 3 3 2 1 4 3 6 4 
0 1 3 2 4 1 3 4 2 1 5 3 1 6 1 1 1 1 2 1 5 2 3 6 3 3 3 2 1 4 3 6 4 
0 1 3 2 4 1 3 4 2 1 5 3 1 6 1 1 1 1 2 1 5 2 2 6 3 3 3 2 1 4 3 6 4 
0 1 3 2 4 1 3 4 2 1 5 3 1 6 1 1 1 1 2 1 5 2 1 6 3 3 3 2 1 4 3 6 4 
0 1 3 2 4 1 3 4 2 1 5 3 1 6 1 1 1 1 2 1 5 2 1 6 3 3 4 2 1 4 3 6 4 
0 1 3 2 4 1 3 4 3 1 5 3 1 6 1 1 1 1 2 1 5 2 1 6 3 3 4 2 1 4 3 6 4 
0 1 3 2 4 1 3 4 3 1 5 3 1 6 1 1 1 1 2 1 5 2 1 6 3 3 4 2 1 4 3 6 3 
0 1 3 2 4 1 3 4 4 1 5 3 1 6 1 1 1 1 2 1 5 2 1 6 3 3 4 2 1 4 3 6 3 
0 1 3 2 4 1 3 4 4 1 5 4 1 6 1 1 1 1 2 1 5 2 1 6 3 3 4 2 1 4 3 6 3 
0 1 3 2 4 1 3 4 3 1 5 4 1 6 1 1 1 1 2 1 5 2 1 6 3 3 4 2 1 4 3 6 3 
0 2 3 2 4 1 3 4 3 1 5 4 1 6 1 1 1 1 2 1 5 2 1 6 3 3 4 2 1 4 3 6 3 
0 2 3 2 4 1 3 4 3 1 5 5 1 6 1 1 1 1 2 1 5 2 1 6 3 3 4 2 1 4 3 6 3 
0 2 3 2 4 1 3 4 4 1 5 5 1 6 1 1 1 1 2 1 5 2 1 6 3 3 4 2 1 4 3 6 3 
0 3 3 2 4 1 3 4 4 1 5 5 1 6 1 1 1 1 2 1 5 2 1 6 3 3 4 2 1 4 3 6 3 
0 4 3 2 4 1 3 4 4 1 5 5 1 6 1 1 1 1 2 1 5 2 1 6 3 3 4 2 1 4 3 6 3 
0 4 3 2 3 1 3 4 4 1 5 5 1 6 1 1 1 1 2 1 5 2 1 6 3 3 4 2 1 4 3 6 3 
0 4 3 2 3 1 3 4 4 1 5 4 1 6 1 1 1 1 2 1 5 2 1 6 3 3 4 2 1 4 3 6 3 
0 4 3 2 3 1 3 4 4 1 5 4 1 6 1 1 1 1 2 1 5 2 1 6 3 3 3 2 1 4 3 6 3 
0 4 3 2 4 1 3 4 4 1 5 4 1 6 1 1 1 1 2 1 5 2 1 6 3 3 3 2 1 4 3 6 3 
0 4 3 2 4 1 3 4 4 1 5 4 1 6 1 1 1 1 2 1 5 2 1 6 3 3 3 2 1 4 3 6 4 
0 4 3 2 4 1 3 4 4 1 5 4 1 6 1 1 1 1 2 1 5 2 2 6 3 3 3 2 1 4 3 6 4 
0 4 3 2 4 1 3 4 4 1 5 4 1 6 2 1 1 1 2 1 5 2 2 6 3 3 3 2 1 4 3 6 4 
0 4 3 2 3 1 3 4 4 1 5 4 1 6 2 1 1 1 2 1 5 2 2 6 3 3 3 2 1 4 3 6 4 
0 4 3 2 3 1 3 4 4 1 5 5 1 6 2 1 1 1 2 1 5 2 2 6 3 3 3 2 1 4 3 6 4 
0 4 3 2 3 1 3 4 4 1 5 5 1 6 2 1 1 1 2 1 5 2 2 6 3 3 2 2 1 4 3 6 4 
0 4 3 2 3 1 3 4 4 1 5 5 1 6 1 1 1 1 2 1 5 2 2 6 3 3 2 2 1 4 3 6 4 
0 4 3 2 3 1 3 4 4 1 5 5 1 6 1 1 1 2 2 1 5 2 2 6 3 3 2 2 1 4 3 6 4 
0 4 3 2 3 1 3 4 4 1 5 5 1 6 1 1 1 2 2 1 5 2 2 6 3 3 2 2 1 4 3 6 3 
0 4 3 2 3 1 3 4 4 1 5 5 1 6 1 1 1 2 2 1 5 2 2 6 3 3 3 2 1 4 3 6 3 
0 4 3 2 3 1 3 4 4 1 5 5 1 6 1 1 1 1 2 1 5 2 2 6 3 3 3 2 1 4 3 6 3 
0 4 3 2 4 1 3 4 4 1 5 5 1 6 1 1 1 1 2 1 5 2 2 6 3 3 3 2 1 4 3 6 3 
0 4 3 2 4 1 3 4 4 1 5 5 1 6 1 1 1 1 2 1 5 2 2 6 3 3 2 2 1 4 3 6 3 
0 4 3 2 4 1 3 4 4 1 5 5 1 6 1 1 1 1 2 1 5 2 2 6 3 3 2 2 1 4 3 6 4 
0 4 3 2 4 1 3 4 4 1 5 5 1 6 2 1 1 1 2 1 5 2 2 6 3 3 2 2 1 4 3 6 4 
0 4 3 2 4 1 3 4 4 1 5 5 1 6 2 1 1 1 2 2 5 2 2 6 3 3 2 2 1 4 3 6 4 
0 4 3 2 4 1 3 4 4 1 5 5 1 6 2 1 1 1 2 2 5 2 1 6 3 3 2 2 1 4 3 6 4 
0 4 3 2 4 1 3 4 4 1 5 5 1 6 2 1 1 1 2 2 5 2 1 6 3 3 1 2 1 4 3 6 4 
0 4 3 2 4 1 3 4 4 1 5 5 1 6 2 1 1 2 2 2 5 2 1 6 3 3 1 2 1 4 3 6 4 
0 4 3 2 4 1 3 4 4 1 5 5 1 6 1 1 1 2 2 2 5 2 1 6 3 3 1 2 1 4 3 6 4 
0 4 3 2 4 1 3 4 4 1 5 5 1 6 1 1 1 2 2 2 5 2 2 6 3 3 1 2 1 4 3 6 4 
0 4 3 2 4 1 3 4 4 1 5 5 1 6 2 1 1 2 2 2 5 2 2 6 3 3 1 2 1 4 3 6 4 
0 4 3 2 4 1 3 4 4 1 5 5 1 6 2 1 1 2 2 1 5 2 2 6 3 3 1 2 1 4 3 6 4 
0 4 3 2 4 1 3 4 4 1 5 5 1 6 2 1 1 2 2 1 5 2 2 6 3 3 2 2 1 4 3 6 4 
0 4 3 2 4 1 3 4 4 1 5 4 1 6 2 1 1 2 2 1 5 2 2 6 3 3 2 2 1 4 3 6 4 
0 4 3 2 4 1 3 4 4 1 5 4 1 6 1 1 1 2 2 1 5 2 2 6 3 3 2 2 1 4 3 6 4 
0 4 3 2 4 1 3 4 4 1 5 4 1 6 1 1 1 2 2 1 5 2 2 6 3 3 3 2 1 4 3 6 4 
0 5 3 2 4 1 3 4 4 1 5 4 1 6 1 1 1 2 2 1 5 2 2 6 3 3 3 2 1 4 3 6 4 